GIUSEPPE	M
MARIA	F
ANDREA	M
MARCO	M
FRANCESCO	M
ALESSANDRO	M
GIOVANNI	M
ROBERTO	M
LUCA	M
ANTONIO	M
PAOLO	M
ANNA	F
FRANCESCA	F
DAVIDE	M
MATTEO	M
GIULIA	F
MARIO	M
LUIGI	M
FABIO	M
PAOLA	F
STEFANO	M
SALVATORE	M
DANIELA	F
LORENZO	M
ELENA	F
CHIARA	F
MASSIMO	M
SARA	F
GIUSEPPINA	F
LAURA	F
GIORGIO	M
RICCARDO	M
SIMONE	M
ROSA	F
SILVIA	F
ANGELA	F
VALENTINA	F
ALBERTO	M
CLAUDIO	M
VINCENZO	M
FRANCO	M
MAURIZIO	M
CARLO	M
ELISA	F
MARTINA	F
GIOVANNA	F
FEDERICO	M
SIMONA	F
PATRIZIA	F
MAURO	M
CARLA	F
GABRIELE	M
CRISTINA	F
ANGELO	M
PIETRO	M
ALESSIA	F
LUCIA	F
MONICA	F
DANIELE	M
RITA	F
MICHELE	M
GIORGIA	F
SILVANA	F
BARBARA	F
DOMENICO	M
MATTIA	M
STEFANIA	F
BRUNO	M
CARMELA	F
SERGIO	M
FEDERICA	F
ROBERTA	F
ENRICO	M
TERESA	F
FRANCA	F
GIANLUCA	M
ANTONELLA	F
CLAUDIA	F
ALESSANDRA	F
LEONARDO	M
LUCIANO	M
SOFIA	F
EDOARDO	M
FABRIZIO	M
ALICE	F
MARISA	F
AURORA	F
TOMMASO	M
MARGHERITA	F
ALESSIO	M
ROSANNA	F
CATERINA	F
ILARIA	F
GRAZIELLA	F
NICOLO'	M
FILIPPO	M
BEATRICE	F
ELISABETTA	F
PIERO	M
TIZIANA	F
CHRISTIAN	M
MANUELA	F
BRUNA	F
DIEGO	M
GIANCARLO	M
GIACOMO	M
VALERIA	F
GIUSEPPA	F
CINZIA	F
ANTONIETTA	F
RENATO	M
SABRINA	F
MARINA	F
LUCIANA	F
IRENE	F
MARTA	F
GIANFRANCO	M
GABRIELLA	F
ELEONORA	F
REBECCA	F
NICOLA	M
NADIA	F
ARIANNA	F
SERENA	F
CONCETTA	F
EMANUELE	M
MICHELA	F
VITTORIA	F
PASQUALE	M
EMANUELA	F
ALDO	M
MASSIMILIANO	M
SAMUELE	M
PIERA	F
LOREDANA	F
GIULIANA	F
EMMA	F
NOEMI	F
ANTONINO	M
ADRIANA	F
GUIDO	M
VERONICA	F
GAIA	F
VITTORIO	M
LUIGINA	F
GIADA	F
MATILDE	F
CARMELO	M
JACOPO	M
VINCENZA	F
JESSICA	F
MIRKO	M
ANNAMARIA	F
FLAVIO	M
VALTER	M
GIULIO	M
GIANNI	M
SONIA	F
ISABELLA	F
GRETA	F
ANTONIA	F
GAETANO	M
CALOGERO	M
ADRIANO	M
RENATA	F
CECILIA	F
DARIO	M
ANNALISA	F
LUISA	F
RENZO	M
MOHAMED	M
MIRELLA	F
LILIANA	F
RAFFAELE	M
UMBERTO	M
CRISTIAN	M
ENZO	M
RAFFAELLA	F
VITO	M
GRAZIA	F
BIANCA	F
CAMILLA	F
ROCCO	M
LIDIA	F
ERIKA	F
IVANA	F
OLGA	F
DANILO	M
EZIO	M
ADELE	F
ORNELLA	F
CARLOTTA	F
NICOLETTA	F
DANIEL	M
MANUEL	M
ROSARIA	F
LUIGIA	F
IVAN	M
DONATELLA	F
ROSARIO	M
ELIO	M
CLARA	F
LUDOVICA	F
CARMINE	M
DONATO	M
SILVIO	M
DOMENICA	F
ALEX	M
MELISSA	F
ROSALIA	F
DENIS	M
LETIZIA	F
MARCELLO	M
GINEVRA	F
EMILIA	F
OMAR	M
MARIANNA	F
ENRICA	F
MADDALENA	F
ASSUNTA	F
THOMAS	M
MARINELLA	F
VALERIO	M
FATIMA	F
MARA	F
MARILENA	F
ARMANDO	M
FILOMENA	F
CESARE	M
SUSANNA	F
CAROLINA	F
GIULIANO	M
WALTER	M
GABRIEL	M
VIRGINIA	F
ELSA	F
LINA	F
IOLANDA	F
ROSSANA	F
SANDRA	F
CAROLA	F
DEBORAH	F
ELVIRA	F
ELDA	F
SILVANO	M
SANDRO	M
GIOELE	M
VERA	F
GLORIA	F
EUGENIO	M
ANTONINA	F
NICOLE	F
GERARDO	M
MARZIA	F
ALFREDO	M
MILENA	F
VIVIANA	F
PIERINA	F
GIANPIERO	M
FULVIO	M
VANESSA	F
DENISE	F
CALOGERA	F
AGNESE	F
DEBORA	F
IDA	F
AHMED	M
KEVIN	M
ASIA	F
UGO	M
ROSELLA	F
FLAVIA	F
GINO	M
ETTORE	M
EMILIO	M
LUCREZIA	F
ANGELICA	F
NELLA	F
VIOLA	F
MARIANGELA	F
ROSALBA	F
DAVID	M
ERIK	M
SECONDO	M
MARIELLA	F
PASQUALINA	F
SEBASTIANO	M
PIERLUIGI	M
VILMA	F
LORENA	F
ROSSELLA	F
LORIS	M
TERESINA	F
TATIANA	F
LUISELLA	F
FELICE	M
KHADIJA	F
NATALIA	F
ANITA	F
ANGELINA	F
ROMINA	F
SAMUEL	M
NICOLAS	M
MICHELINA	F
INES	F
MICHAEL	M
ERICA	F
AGOSTINO	M
NICHOLAS	M
GIANPAOLO	M
ANA	F
FABIANA	F
MARCELLA	F
AMELIA	F
RACHELE	F
ROSINA	F
IRMA	F
SALVATRICE	F
CORRADO	M
BENEDETTA	F
RINA	F
MAURA	F
MOHAMMED	M
EVA	F
NATALINA	F
YOUSSEF	M
REMO	M
PIERPAOLO	M
MARIAGRAZIA	F
FIORELLA	F
STELLA	F
ALFONSO	M
LIVIO	M
GUGLIELMO	M
CRISTIANO	M
SAID	M
GENNARO	M
SAMANTHA	F
MORENA	F
FERDINANDO	M
ADELINA	F
VASILE	M
CARMELINA	F
FLORA	F
FIORENZO	M
CRISTIANA	F
MARIKA	F
AMEDEO	M
RAFFAELA	F
DIANA	F	
GAETANA	F	
SANTINA	F	
ION	M	
ENZA	F	
MIRIAM	F	
COSIMO	M	
ONOFRIO	M	
PIERGIORGIO	M	
CIRO	M	
KATIA	F	
VALENTINO	M	
IRIS	F	
ADA	F	
AICHA	F	
NICCOLO'	M	
NUNZIO	M	
SANTA	F	
RAYAN	M	
ROSETTA	F	
ALI	M	
ARBEN	M	
ESTER	F	
LORENZA	F	
NATALE	M	
MIRANDA	F	
ADAM	M	
FATIHA	F	
LUANA	F	
IVANO	M	
ILEANA	F	
CHLOE	F	
AMBRA	F	
EUGENIA	F	
LORELLA	F	
FERRUCCIO	M	
MIRCO	M	
EMILY	F	
YASMINE	F	
AGATA	F	
MIHAELA	F	
GIANLUIGI	M	
LIVIA	F	
CARMEN	F	
IMMACOLATA	F	
DAMIANO	M	
GREGORIO	M	
FAUSTO	M	
ENEA	M	
PAOLINA	F	
ORIANA	F	
GINA	F	
SARAH	F	
LUIGINO	M	
ORAZIO	M	
DONATA	F	
LISA	F	
SANTO	M	
JENNIFER	F	
YASSINE	M	
IRINA	F	
ISABEL	F	
ELIA	M	
AMALIA	F	
VICTORIA	F	
GIAMPIERO	M	
ALDA	F	
ESMERALDA	F	
ILENIA	F	
CONSTANTIN	M	
ROMANO	M	
PIERINO	M		
ALMA	F	
AZZURRA	F	
EDMOND	M	
GRAZIANO	M	
SVETLANA	F	
GIOACCHINO	M	
AYA	F	
NINA	F	
MARTINO	M	
LINDA	F	
LORETTA	F	
IGNAZIO	M	
ANNUNZIATA	F	
ROSANGELA	F	
FULVIA	F	
OSVALDO	M	
SECONDINA	F	
RACHID	M	
PAOLINO	M	
MUSTAPHA	M	
DELIA	F	
MARIANA	F	
ITALO	M	
FABIOLA	F	
FERNANDA	F	
ZAHRA	F	
ACHILLE	M	
LARA	F	
IVO	M	
MICAELA	F	
HASSAN	M	
FERNANDO	M	
ALEXANDRU	M	
ABDERRAHIM	M	
VIOLETA	F	
PIERANGELO	M	
CLELIA	F	
CELESTE	F	
EMANUEL	M	
ANILA	F	
VINCENZINA	F	
IGOR	M	
ANTONELLO	M	
MARIATERESA	F	
DANTE	M	
MARIALUISA	F	
TAMARA	F	
ROMANA	F	
RINO	M	
AMINA	F	
ELIANA	F	
SAMIRA	F	
ROMEO	M	
CELESTINA	F	
MARTIN	M			
HAMZA	M	
AURELIA	F	
SOPHIA	F	
FATNA	F	
DINO	M	
SHARON	F	
BENEDETTO	M	
GHEORGHE	M	
HAJAR	F	
TIZIANO	M	
ERNESTO	M	
GEMMA	F	
VITA	F	
MARIUCCIA	F	
PAMELA	F	
RENZA	F	
ALTIN	M	
PETRIT	M	
MICHELANGELO	M	
MIRIANA	F	
HICHAM	M	
SIMONETTA	F	
ATTILIO	M	
AURELIO	M	
MIA	F	
VALBONA	F	
COSIMA	F	
NUNZIA	F	
AUGUSTO	M	
MARIAROSA	F	
SAVERIO	M	
GEZIM	M	
EDUARD	M	
OSCAR	M	
CLARISSA	F	
KRISTIAN	M	
ALFRED	M	
ERNESTINA	F	
FATMIR	M	
MICHELINO	M	
ARTAN	M	
VITTORINA	F	
KLEA	F	
MANUELE	M	
CONCETTINA	F	
AMANDA	F	
OTTAVIO	M	
BESNIK	M	
DINA	F	
NORA	F	
LUCIO	M	
ORIETTA	F	
ORLANDO	M	
ZAKARIA	M	
MARINO	M	
ANGIOLINA	F	
SERAFINA	F	
WILLIAM	M	
ARTUR	M	
NICOLINA	F	
PIERCARLO	M	
MICHELLE	F	
ELIA	F	
ALBINA	F	
MIRELA	F	
LINDITA	F	
RODOLFO	M	
PALMA	F	
REGINA	F	
SABINA	F	
AMIRA	F	
EGLE	F	
LEANDRO	M	
AUREL	M	
VANDA	F	
ORESTE	M	
GERMANA	F	
RODICA	F	
ALEXANDRA	F	
MAURIZIA	F	
IBRAHIM	M	
GIANNA	F	
EMILIANO	M	
PRIMO	M	
SAVINO	M	
OMBRETTA	F	
FIORENZA	F	
AYOUB	M	
NAIMA	F	
LEONARD	M	
FELICIA	F	
ALIDA	F		
EVELINA	F	
SERGIU	M	
GIAMPAOLO	M	
MATILDA	F	
TERESIO	M	
ANGIOLETTA	F	
MATHIAS	M	
PATRIZIO	M	
ESTERINA	F	
BENITO	M	
BRYAN	M	
SAMANTA	F	
ALBERT	M	
BLEDAR	M	
AMINE	M	
MINA	F	
AGRON	M	
DORINA	F	
ANDREI	M	
ARTURO	M	
GASPARE	M	
LAILA	F	
LAURETTA	F	
ALBA	F	
GIANMARCO	M	
SAIMIR	M	
DEVIS	M	
GABRIELA	F	
SALAH	M	
EDDA	F	
EDI	F	
NORMA	F	
ADOLFO	M	
ERMANNO	M	
DILETTA	F	
MIMOZA	F	
ARJAN	M	
GIANCARLA	F	
NICOLETA	F	
RINALDO	M	
GERARDA	F	
STIVEN	M	
GENTIAN	M	
GERMANO	M	
FORTUNATO	M	
EMILIANA	F	
KATIUSCIA	F	
VIORICA	F	
ANTHONY	M	
ANAS	M	
PRANVERA	F	
AIDA	F	
STEFAN	M	
ECATERINA	F	
AZIZ	M	
VICTOR	M	
DRITA	F	
DEMETRIO	M	
ANDREA	F	
HANANE	F	
BIAGIO	M	
SONJA	F	
DENNIS	M	
CLOE	F	
ALINA	F	
MANJOLA	F	
MARISTELLA	F	
SEBASTIAN	M	
GIOVANNINA	F	
MAJLINDA	F	
DENISA	F	
PASQUALINO	M	
MARINELA	F	
ILIR	M	
NATHAN	M	
ZOE	F	
MORENO	M	
ALEKSANDER	M	
CATTERINA	F	
MARIANO	M	
GIROLAMO	M	
GIUDITTA	F	
KRISTINA	F	
NADEJDA	F	
RAIMONDA	F	
ERSILIA	F	
AMAL	F	
ENDRI	M	
FLORIN	M	
SOKOL	M	
ARNALDO	M	
GIACINTO	M	
OLIVIA	F	
KARIM	M	
ROSITA	F	
CHANEL	F	
FILIPPA	F	
MOUSSA	M	
ADIL	M	
ADAMA	M	
ERVIS	M	
LUIS	M	
GERARDINA	F	
MARIUS	M	
ABDELLAH	M	
NICOLAE	M	
PIA	F	
MAGDA	F	
GIANNINA	F	
MARICA	F	
BLESSING	F	
MARJETA	F	
FLORIANA	F	
LINO	M	
KLEVIS	M	
ONORINA	F	
SONILA	F